00000111110000022222
00000111110000022222
33333111113333322222
33333000003333300000
11111022201111100000
11111022201111133333
00000022200000033333
22222033302222011111
22222033302222011111
22222033302222011111
00000033300000000000
11111022201111122222
11111022201111122222
33333000003333322222
33333111113333300000
00000111110000000000
22222111112222233333
22222000002222233333
11111033301111133333
11111033301111133333
