000000000000000000000000000000
000005000000010000000000001110
000005500000111100000000000010
000005000000011100000000004000
000055550000001000000000044400
000005500000000000000000444440
000005550000000000000004444400
000000550000000000000004444440
000000000000000000000004444440
000000000000000000000044444440
000000000000000000003004404440
000000000000000000033300044440
000000000000000000000330444400
000100000000003000000300044400
001111100000003000003333000000
000101110330033300000330000000
000001110333330300000033000000
022200100033000004444000000000
022220000033000004444400000000
002200000003000004444440000000
002200000000000400440440000000
002200000000004444444000000000
022000000000000444440033300000
022000000000000044400033000000
022000000000000040440003300000
020000100300000000400333000000
000001110330010000000000000000
000001110330111000000000000000
000000000030111000000000000000
000000000000000000000000000000
