11112222333300000000
11112222333300000000
11112222333300000000
11112222333300000000
11112222333300000000
11112222333300000000
22223333000011112222
22223333000011112222
22223333000011112222
22223333000011112222
33330000111122223333
33330000111122223333
33330000111122223333
33330000111122223333
11110000333322220000
11110000333322220000
11110000333322220000
00002222111133330000
00002222111133330000
00002222111133330000
