22222222000033330000
22222222000033330000
22222222000033330000
11110000111100001111
11110000111100001111
11110000111100001111
00003333000022220000
00003333000022220000
00003333000022220000
11112222111133331111
11112222111133331111
11112222111133331111
00001111000022220000
00001111000022220000
00001111000022220000
33330000333300002222
33330000333300002222
33330000333300002222
11110000111100003333
11110000111100003333
