000000000000000000000000000000000000000000000000000000000000000000000000000000000000000000000000000000000000000000000000000000000000000000000000000000
022220022022222222011111100110000000000000033333000303033330000000011111100000000000100000000000022022222002200000000000000000000000000000000000000000
002222222202022220000010111111000000000000033303033303333000000000111111111100000000101010000000022222222202220000000000000000000000000000000000000000
022222022020222200001110011111000000000000030333033303333300000000111011110000000011111111003000002022022222220200000000000000000000000000000000000000
020222222220020000000110001111100000000000030333333333333000000000010001100010000000100110033300000222222222202220000000000000000000010000000000000000
000220222200000001100000000011000000000000000030333333303300000500000001110111000000001111033000000222222222222200000000000000000001111000000000000000
022222222000000000111000000000000000000000000000000333033300005550000000011111100000010010003330000222202222222220000000000000000001111100000000000000
022022222220000000011000000000000000000000000000000033333305555000500000001111000001110100003330000022222222200000000000000000000001111000000000000000
020022222222000011111100000000000000000000000000000033300005555500550000001110000000111110333330000000020222220000000000000000000000010000110000000000
000000220220000111110000000000000000000000000000000033333000505555555000000100000001111100333333300020222222220000000000000000000000000001111000000000
000022222200000111100000000000000030000000000000000000330000555550550000000000000000110003033000002222222222022200000000000000000000000000111100000000
000002222200000011000000000000000330000000000000000000000000555555000000000000000000000003330000000200222022022220000000000000000000000000011100000000
000000002220000000000000000000003300000000000000000000005005555055500000000000000000000333330000000002222220222222000000000000000000000000001000000000
000000222222000000000000000000000333330000000000000000055555555555000000000000000000000030330003330022222220222200000000000000000000000000000000000000
000000222220000000000000000000003303300000000000000100005555000000000000000000000000000000333333330002222022222222000000000000000000000000000000000000
000000022200001000000000000030033330333000000000001100005555000000000000000000000000000000030333033300020022202220000000000000000000000000000000000000
000000002000011100000000003333333333333000000000001111000550000000110000000000000000000000000003333300000002200000000000000000000000000000000000000000
000000000000011101000000003333303330300011000000111110000000000011111000000000000000000000000333333330000022200000000000000000000000000000000000000000
001100000000001111100000000330300333330111000000011100000000000001111000000000000000000000033033333330000022000000000000000000000000000000000000000000
011110000000001111110000033333330003330011110000000000000000000000110000000000000000000000333333300300000002000000000000000000111010000000000000000000
001100000000200111111000003303333003333000110000000000000000000000010000000000000000000000033330003300000000000000000000000000111011000000000000000000
011110000002220011111000000003330000303301100000001110000000000000000100000000000000010003330333000300000000000000000000000000111111000000000000000000
011000000002222001100000000033333300033000000000001111000000000000111110000000000001110003333330000000000000000000000000000000000110000000000000000000
000000000000202200000000000000003000000010100000001011000000000000011100000000000000110000333300000000000000000000000000000000000110100000000000000000
000000000022222200200000000000000000000111111000000011000000000000111000000000000000111000033333000000000000000000000000000000011111110000000000000000
000000020222222222220000000000000000000011111001101111000000000000011100000000010000111100003330000000000000000000000000000000011111100000000000000000
000000222022002222220000000000000001000111111011110110000000000000011100000001111000111110000000000000000000000000000000000000000000000000000000000000
000000022220222222000000000000000011100010111111110010000330000000001000000001101100111100000000000000000000000000000000200000202000000000000000000000
000000222222022222200000000000000111110000001101111111100330000003300000000001111110000000000000000000000000000000000000200002222200000000000011100000
000000022022202222200000000000000011100000001000111111110033000000300000000000111110000000000000000000000220000000000002222202222020000000000011110000
000000022222222222220000000000000000000000000000011011111030300333333000000000000100010000000000000000000222000000000000220022222222000000000011100000
000022222220222222222000000000000000000000000000000111110033333333330000000000000001111000000000222000222220000000000002200002222222200000000001000000
000222222222222222220000000000000000000000000000000011100333333303033000000000000011111000000002222200222200000000000022220222222222200000000000030000
000022202222222200000000005000000000000010000000000111003333003300000010000000000000110000000000202002222220000000000222202222022202000000000003333330
000000200222002000000000005500000000000110000000000010033330333300000110000000000000100000000000002202022222000000022222222222200000000000000333333330
000000022220000000000000005555000000000111100000000000000303303300000011100000300000003000002000022222220020000000002200222222220000000000000030333330
000000002000000000000000000555050000001110000000000000000300303000001110000000300003333002202202222222222222000000000000002200200000000000000000003330
000000000000000000000000005555550000000111100000000000000000000000000110003003330000033022222000202222222220000000000000222222200000000000000000033030
000000000000000000000000055500500000030111100000000000000000000000000111103300303000030000222202222222200222000000000000022222200000000000000000033330
000000000000000000000005555000555033030011000000000000011000000000000011003303333000330022222222222220000220000000000000000022200000000000000003333300
000000000000000000000005555550550030033010003000000000111100000000000000003330333333330222222222222222000000000000000000000022000000000000000103300330
000000000000000000000000055550000030333000333300000000011000000000000000000333330330000222222222220220000000000000010000000002000000000000001100003300
000000000000000000000000005555000033333033333000000000111100000000000000003330030333302222222022220000000000000000111100000000000000000000011111100300
000000000000000000000000000550003330303333300000000000001100000000000000000333330033302222202200000000000000000001111110000000000000000000001011110300
000111010000000000022000000000000000300330030000000000000000000000003300000300003333000222220005000000000000000000011110000000000000000000000111100330
000011110000000020022000000000000000000033333000000000000000000000333330000000003333022220220505500000000000000000000110000000000000000000000001103300
000011111000000022222202000000000000000033330000200000000000000003333000000000000330002222000555500000002220000000000000000000000000000000000000003300
000001111000000222222222200000000000000003333000220000000000000000303000000110000000100222055555500000222200000000000000000000000000000000000000000000
000000000000002222220222200000000000000003300022220000000000000000333330001111000011100220000555500000022222000000000000000000000000000000000001000000
001100000000000020222222000000000000000033300000202000000000000000033300000100000000110000000550000022222222022000000000000000440000000000000101100000
011110000000000222222222200000000000000003002202222200000000000000333000010110000011110000055550000000222222222200000000000004444444444000001111100000
001100000000002222222222200000000001000000002220222000000000000003033000111110000001100000055505000002222002202001000000000000444444444400001100000000
000110000000002220222222222000000011101002222022222000000000000003330300011100000000000000005555000220222002200011000000000004444444444000000100000000
011110000000000022222020222200000011111022202222222220000000000000333303000100000000000000550550020022222002001111110000000000444044400000000000000000
000100000000020222000020022000000000100022222022202220000000000003330333300000000000000000055550220222220000000101100000400044444444400000000000000000
001100000000020222020000002000000000000220222220202200000000000033333300000000000002000000555550222222220200000011000000444004444440000000000000000000
000100000000022202220000000000000000002222220222002200000000000030333000000000000202200005555550022022222200000000033000444044444044000000000000000000
000000000000022222222200000000000000002220022220000000000000000000330000200002202202000000050550000022222200033330333044444440404444000000000000000000
000000000000000200220000000000000000002222222220000000000000000000000002200222222222220000000000000000222000303333300004444444440044400001000000000000
000000000000000000220000000000000000002202222220000000000000000000000000222200222202200000000200000022200000333333303044440400000044400011100000022220
000000000000000000000000000000000000002222222220000000000000000000000022222222022022200000000222200022220000333333333044444400100004000011100000002020
011111000000000000000000000000000000000222222222000000000000000000000000222022222222220000020222220022200330303330333004444001110000000011100000222020
011110000000000000000000000000000000200222222222200000000000000000000002222222222222222000220222002002000033300000003304444011110000000011100000222220
011110000000000000000000000000000002222222222222200000000000000000000002222222200220000020022222022000000003300100033300404011111000000000000002002220
010011000000200000000000000000000000222222222222200000000000010010000000022222220000000222222202022200000003301110330300004001110000000000000002222020
000000000002222020020000000000000000022220222222000000000000010011000000022222222000000000202222222000000333000100033003000001000000000000020002222220
000000000002222222222000000000000000020222222020000000000000010110000000022202000030000000202222220000000333001111003333300000000000000000222202222220
000000000002222202222000000000000002222222222220000000000000111100000010000000000330000002220222222200000033011110033003300000000000000000022222222000
000000000002222222202220000000000000222200022220000000000000001100001111000333303333000002222222222000000333011110033300330000000000200022222022222000
000000000000222222022220000000000200020200002220000000000000000000011111000303303333000002222202002010100330011100000000300000000022220022220222200200
000000000000222222222222000000022220000000002220000000000000000000011110003303030330000022222222220011110030010000000000000000000222222202022220222220
000000000000202220222222200222222220000000000200000000000000000000001011103333333330000022222222220011100000000000000000000000000022220222222222220200
000000000002222222222222202222222222000000000000000000000000000000000001003333333033000002022222220110000000000000000010000000000222222222202220220000
000000000000222022222222000202202220000010003303000010100000000000000000033303333333300000002222200010000000000100000111000000002222220222222222200000
000000000000000002202222222222222200000111033303001011110000000000000000003330330333000000000000000000000001010110000111000000000220222222222222000000
000000000000002220020220222222222020000010003333011111000000000000000000000333330300000000000000000000000001111110000011100000000000020202222022000000
000000000000022222022222222222222222001111103033001101100000000000000000000033030300000000000000000000000001101010000001000000000000000202020222011100
000000000000000222222200222200222222000100003330300101000000000000000000000003000300000000000000000000000000000000000001100000000000000000020220011100
000000000000022202222222022222222220000000033003330000000000000000000000000000000000000000000000000000000000000000000011000000000000000000000020011100
000000000000222222222220020022222200000000003333303333000000000002000000000000000000000000000000000000000000000000000011000000000000000000000000111100
000000000000022222200222222002222000000003330333333330000000000022200000000000000000000000000000000000000000000000000001000000000000000000000000010000
000000000000000222202222020000200000000033333333033300000000000022000000000000000000000000000000000000030000000000000000000000000000000000000001111000
000000000000000022022222000000000000000000300000333300000000000022020000000000000000000000000000000000333333030030000000000000000000000000000000111100
000000000000000020000222000000000000000000000003333330000000020222222200000000000000003000000000000000033033333033000000000000000000000000000000001000
000000000001100000000200000000000000000000000000003000000000222222222220000000000003333030000000000000000033303333300000000000000000000000000000000000
000000000111110000000000000000000000000000000000033000000000002222022200000000000003333330030000000000000000003330000000000000000000000000000000000000
000000001110111000000000000000000000000000000000003000000000002222222000010000000003303333333000000000000000000033300000000000000000000000000000000000
000011111111110000000000000000000000000000000000000000000000020222222200111000000000033303300000000000000000000033000000000000000000000000000000000000
001101111111100000000000000000000000000000000000000000000000222220220220011000000000330333330000000003000000000000000000000000000000000000000000000000
000111110111100000000000000000000000000000000000000000000000002022222222010111000000030033330000000033300000000000000000000000000000000000000000000000
000011001100100000000000000000000000000000000000000000000002222222220222011111100000003333033033033333000000000000000000000000000000000000000000000000
000000001100000000000000000000000000000000000000000000000022222222022220001111000000003030033330003030330300000000000000000000000000000000000000000000
000000111100000000000000000000000000000000000000000000000002202222222200001100000000333330033300000033333300000000000000000000000000000000000000000000
000001011100000000000000000000000000000000000000000000000000022222222000000000000003330033333330330033330303000000000000000000000000000000000000000000
000011110000000000000000000000000000000000000000000000000010222220200000000000000000333003333303033303333333000000000000000000000000000000000000000000
000001011000200000000000000000100000000000000000000000000110022000000000000000000000333000303333033333330000000000000000000000000000000000000000000000
000000000002222020000000000001110000000000000000000000000111000000000000000000000000000000003333333333333000050000000000000000000000000000000000000000
000000000000222222200000000001111000000000000000000000000111100000000000000000000000000000000003333000000000555000000000000000000000000000000000000000
000000000020222222200000000001110000000000000000000000000111000000000000000000000000000000000003033000101005555500000000000000000000000000000000000000
000000002222022022220000000001000000000000000000000000011100000000000000000000000000000000000003303000111105555550000000000000000000000000000000010030
000000000220202222000000001111000000000000000000000000000000000000000000000000000000000000000000033301111100055555055000000000000000000000000011111000
000000000222222222000000000010000000333000000000000000000000000000000000000000000000000000000000003001111111055555555500000000000000000000000001110030
000000022222220000000000000000000003330000000000000000000000000000000000000000000000000000000000000001111100055055555000000002000000000000000110110330
000000222222222020000000000000000330300000330000000000000000000000000000000000000000000000000000000001111100555055500000000222200000000000000111110330
000000022202022220000000000000033333330000333000000000000000000000000000000000000000000000000000000000111110550055000000000222000000000000001110000030
000000002222222220000000000000333330330003333000000300030000000000003300000000000000000000000000000000111100550000000000000220000000000000001100303330
000000002222022000000000000000033033300300330000003330030000000000003330000000000000000000000000000001101000550000000000000200000000001000011110333330
000000000222222000000000000000000030330333030000000303330000000000033000000000000000000000000000000001110055500000002000002222200000001000001000333330
000000000022220000000000000000003333333330333030033333333300000000003300000000000000000000000000000000000000000000022002222222220000011101101003333330
000000000002200000000000000000000033330333303333333033333300000300003330000000000000000000000000000000000000000000022022222222220110111111111100000330
000000000000000000000000000001110003330000033030033333303300000330003333300000000000000000000000000000000000000000022002222200200111111101111001110030
000000000000000000000010000001110000000100000000000333300033333330333333000000000000000000000000000000100000001000222222222020000010111101000011111000
000000000000000000000111000000110001111110000000000033000333333333333300000000000000000000000000000001100000001000222222022222000000110000000001011000
000000000000000010001111100001110001111100000000000000000030330333303330000300000000000000000000001100110101111002222222022020000000000000000000010000
000000000000000111111011000111100000100000000000000000000330333300333333333300000000000000000011111111111111111100222020222000000000000000000222000000
000000000000000001001000000011110000000000000000000000000030303000003030333333000000000000000011111111111100001110022022220000000000000000202222000000
000000000000000000000000000001110000000000000000000000000333033300303333333333300000000000000000111111000000001100000222020000000000000002222222022000
000000000000000000000000000000100000000000000000000000000033330300333303300303000000000000000000001000000000000000000200000000000000000002222220222200
000000000000000000000000100100000000000000000000000000000000033000003333333000000000000000000000000000000000000000000000000000000000000022222022202220
000000000000000000000000111110000000000000000000000000000000030001100330330000000000000000000000000000000000000000000000000000000000000022202222222220
000000000000000111000000011110000000000000000000000000000000000011110333333000000010000000000000000000000000000000000000000000000000000020202002202220
000000000000011111100000111111000000000000000000000000000000000001110333030000000010100000000000000000000000000000000000000000000000000000022222222220
000000000000000111100001111111100000000000000000000000000000000001100000000000000011100000000000000000000000000000000000000000000000000000002222220220
000000000000011110000011111101000000000000000000000000000000000001000000000000001111100000000000000000000000000000000000000000000000000000000222220220
000000000000000000200000110000000000000000000000000000000000000000000000000000000100000000000000000000000000000000000000000000000000000000000022222220
000000000000000202222020000000000000000000000000000000000000000000000000000000000000000000000000000000000000000000000000000000000000000000000000222220
000000000000002220222022000000000000000000000000000110100000000000000000000000000000000000000000000000000001010000000000000000000000000000000010222000
000000000000002222222222000000000000000000000000001111110000000000000000000000000000000000020000000000000011110000000000000000000000000000000110020000
000000000000222220222222000000000000000000000000000110100000000000000000000000000000000022222000000000000001111110010100000000000000000000000111000000
000000000000002222222222200002002200000000000000000110000000000000000000000000000000000222222000000000000000110100111110000000000000000000001111110110
000000000000222202022220222222022220000000000000000000000010000000000000000000000000000002220000000000000000100000011000000000000000000000000111111110
000000000000202022220022222222222220000000000000000000000110000044000000000000000000000022222220000000000000000000011100000000000000000000000000000010
000000000000222022222022202222202200000000000000000000000011104444400000000000000000000002222222000000000000000000111000000000000000000000000002202000
000000000022202222202222222222222222000000000000000000000111100444400000000000000000000022002222000000000100000000010000000000000000000000000222222200
000000000000222222220202000220202220000000000000000000001111110444400000000000000000002222220220000000001110000000000000000000000000000000022220222200
000000000000022220022200000002222200000000000000000000000011100444400000000000000000022222222200000000001110000000000000000000000000000000222200222000
000000000000222200002201100000222220000000000022200200044001004040000000000000000000000222220000000000011110000000000000000000000000000000202222222000
000000000000222200000001102200222220000000020022220220444000044440440000000000000000002220220000000000001110000000000000000000020000000002222222202000
000000000002220000011111100222202220000000220222222200444044040444444000000000000000002222220000000000000000000011000000000000222002000000222022222000
000000000000222200011111102222222000000000222202022200044404444444444400000000000000002222220000000000000000000111000000002022222222200000002222202200
000000000000022000001101000222222000000002220222222220044444404400444440000000000000002222200000000000000000000111100000022220222222202000220222222220
000000000000000000000100000002222000000002222222222022044444444444444440000000000000002220000000000000000000000011000002002022220200222202222222022200
000000000000000010001000000022222000000022222222022222044444444400044000000000000000022220000000000000000000000000000022202222222220220002220222222220
000000000000000111101100000222220000000000222222222220004400444000444000000000000000222222220000222202000000000000000222222202222220222000220020222220
000000000000001111111110000222220000000000222222222220004400044000040000000000000002020202200222202022200000000000000020222222022222020000002222222200
000000000000001111010100000000000000000000022222022200444440044444000000000000000002002222202222222222200000000000000000222222222222200000002200200000
000000000000011111010000000000000000000000002222220200444400444444400000000000000022222202222222222220220000000000000002202222220220000000000200000000
000000000000011111100000000000000000000000000202200000004000040444000000000000000022222202222222220200000000000000000000022222222200000000000000000000
000000000000111011000000000000000000000000000002000000000000000000000000000000000002222022222022200000000000000000000000002022222220000000000000000000
000000000000000000000000000000000000000000000000000000000000000000000000000000000000000000000000000000000000000000000000000000000000000000000000000000
