0000000000000000000000000000000000000000000000000000000000000000000000000000000000000000000000000000
0000000000044440004000000000003303033333333330000000000000000000000000000002222220000000000000000000
0000000444444444444400000000033333000333030300000000000000000000000000000222222200000000000000000000
0000000044444444404000000000000333000003330000000000000000000000000000000022022200000000000000000000
0000000004444444440000000000000033300000300010000000000000000000000000000000220200000000000000000000
0000000044044404444000000000000333300000000110000000000000111000000000000110020000000000000300000000
0000000044444444444000000000110003333000000011110000000000111100000000000111022000000003333300000000
0000000440444444044400000001111003330000001101000000000000101111100001011110020000000003303300000000
0000000004444004444000000000111003300000001101110000000000000111110011011100220000000003333330000000
0000001004440000040000000000111103000011011111111000000000000001100001111100200000030000333000000000
0000011100000000000000000001110000000110101111010000000000001001000011101000000000330003300010000000
0000111100000000000000000001110000000111111101000000000011101000000011100000000000030003301011000000
0000011100000000000000000000100000000010111000000000000111111000000001000055005000333333301110000000
0000001000000000000000300330000000000000100000000000000000111100000000000555055550003303001111000000
0000000000000000000000333330000000000000000000000000000000111000000000000555505555000333000011000000
0003000033000000000000003030000000000000000000000000000000011000000000005505555555000333301111000000
0033300030033000000000003330000000000000000000000000000000000000111000055555550050000030000111000200
0003300330330000000033033303000000000000000000000000000000000001111100005055550000000333000010002220
0333333333333000000033330333000001110000000000000000000000000001101000000000500000000030002000202220
0033000033333300000000333333000011111000000000000000000000000000100000000000000000000000022222222200
0003000003303300000003333330000111010000000000000000000200000000000000000000000000000000002222022200
0000000003300000000033333330000001000000000000000000000222000000000000001000000000000000222200000000
0000000000300000000000330300000000000000000000000000002222220000000000011100000000000000000000111000
0000000000000000000003300000000000000000000000000000002222220000000011111000000000000000001111111110
0000000000000000000000000000000000000000000000000000000222220000000011111100000000000000000011101000
0000000000000000000000000000000000000000000000000000000000220000000011111000000000000000001110111100
0000020000000000000000000000000000000000000000000000000000200000000001101033000000000000000110011000
0000222200000000000000000020000000000000000000000000000000000000000001101033000000000000000000000000
0000022200000000000000000222000000000000000000000000000000000000000000100033300000000000000000000000
0000022000000000000000000002200000000000000000000000000000000000000000000030000000000000000000000000
0002220200000000000000000222000000000000005000000000000000000000020000000033033000000200000000000000
0002022222000000000000000222200000000000055005500000000000000000222200003333333000002220010000000010
0022222222200000002200000222220000000000055505500000000000000000222220003303300010002200111000001110
0002222222000000022220000002200000000000005555000000000000000000222020033333001011002201111000011010
0000002220000000222200000000000000000000005505500000000000000000022222033003011111102201111000011110
0000000200000002222200000000000000000000000000555000000000000002222000033033000011002201101100001010
0000000000000000222220000000000000000000000000550500000000000002222200330000000111022200001000000010
0000000000000002222222000000000003000000000000555500000000000002222000030001011000022000000000000000
0000000000000000202220000000000003300030300000555555000000000100002000000011110100222000100000000000
0000000000000000002200000000000003033333330000555555000000001110000000000111011110220011100000000000
0000000000000000000000000000000033333333330000005500000000000111000000000011001000020011100000000000
0000000000000000000000000000003333330333333300055550000100000111000000000000011100000011100000000000
0000000000000000000000000000000033303303333300055550001110001110000000002222001000000011000000000000
0000000000000000000000111000000303000333330300005000000111100100000000002222200000000000000000000000
0000000000000000000001111103033333003333333333000000011111000000000000002220200000000000000000000000
0000110000000000000000011003333300003300333300000000000001100000000000002022020200000000000000000000
0001111111000000000000000003333000003000330300000000000000000011100000000022222220000000000000000000
0001110110000000000000030000333000000000330000000000000000001111110000000020202200000000000000000000
0001000111000000000000333000000000000000330010000000000000000111100000000002220000000000000000000000
0000000011100000000030333000000000000000000111001000000000000010000000000000200000000000000300000000
0000000111000000000333330000000000000000000111111000000000000000000000000000000000000011003300000000
0000010001000000000030333330300010000000000000000000000000000000000000000000000000000011103330000000
0000111000000000000000303303330111000000000000000000000000000000000000000000000000001111003000000000
0011110000000000000000003333300011000000000001000000000000000003300000000000000000001111003330300000
0011100000000000000000033333301111100000000011100000000003333303300000000000000000000100033330330000
0001000000000000000000033330300110000000000011110000000033330333000000000000000000020000030033300000
0011110000000000000000003330000000000000000001100000000003333303300000000000000000222022033300330000
0001100000000000000000000000000222220000000000000000000333003333333000000000000002222222033000300000
0000000000000000000000000000002022002200000000000000000030000000330000000000000000222202033000000000
0000000000000000000000000000002222222000000000000000000000000000000000000000000000222000033330000000
0000000000000000000000000000002222222000000000000000000000000000000000000000000000020000333330000000
0000000000000000000000000000002222220000000000000000000000000000000000000000000000000003333033000000
0000000000000000000000000000000222220000000000000000000000000000000000000000000000000000000000000000
0000000000000000000000000000000002200000000000000000000000000000000000000000000000000000000000000000
0000000000000000001100000000000000200000000000000000000000000000000000000000000001110000000000000000
0000303000000000001100000000000000000000000000000000000001010000000000000000000001111000000000000000
0000333300000000001111000000000000000300000000000222220111111000000000000000000011111100000000000000
0000003330000000011011000000000000003330000000000022220111110000000000000000000000010000000000000000
0003033330000000001110000000000000303330000000000220220111100000000000000000000000110000000000000000
0003333300033000000010000000000003333333000000000022000010000000000000000000000000010000000000000000
0033333303333300000000000000000000333333333001002222000000000000000000000000000000000000000000000000
0033303333333300000000000000000033330033330011100200000000000000000000000000000000000000000000111000
0033003030033300000000000000000033303033000111110000000000000000000000000000000000000000000000111000
0003000000000333000000000011000000303330300001100000000000000000000000000000000000000000000011111000
0000000000033300333300220111100000333333330011100000000000000200200000000000000000000000000000111100
0000000000003333333302220011100000030303000001000000000000002222200000000000000000000000000000100000
0000000000000330033000022001000000000330000000000000000000000022220000000000000000000000000000000000
0000000001000300033330222200000005050000000000000000000000000022220000001000000000000000000000000000
0000000111100000033330222222005555555000000000000000000000000222222000011100000000000110000000000000
0000001111010033333330222000005055050000000000000000000010000222222000011100000000001111000000000000
0000000111110030033300220050055555550000000000000000000110000222220001111100000000011110000000000000
0000000001110000333002220555555055500000000000000000001111100002222000111100000000000000000000000000
0000000000000000303022220055555550000000000000000000000110000002222000011000000000220222000000000000
0000000000000003303000220000555500000000000000000000000000000000222000000000000002202202200000000000
0000000000000033333000000000055000000000000000000000000000000000222000000000000222222222220000000000
0000000000000003333000000000000000000000000000000000000000000000020000000000000022222222220000000000
0000000000000000330000000000000000000000001000000000000000000000000000000000000022222220222010000000
0000000000000000000000000000000000000000011110000000000000000000000000000000000002220200220010110000
0000000000000000000000000000000000000000001100000000000000000000000000000000000222222222000111111000
0000000000000000000010000000004400000000001110000000000000000000000000001000000020222020000111010000
0000000000000000000111100000044440000000200010000000000000001100000000001110000000022222200011100000
0000000000000101110011110000044444400002222000000000000000011100000000011111000000022222000001000000
0000000000000111100010100040004404000000222220200100000200111110000100011010000000000000000000001000
0000000000001101110000000444400444000000222220201100000201111100011101001000000000000000000000011100
0000000001001100111000000444404444400000202022200111110200111002000111000000000000000000000000011010
0000010011100100011000000004444400440002222222000011110220000022220111000000000000000000000000011110
0001111111110000111000004444404444444400222022200001110222000002220111000000000000000000000000001010
0011111001111000010000000444404444444000022022200000100022202222200110000000000000000000000000000000
0001110000110000000000000040444440444400002002200000000000222222200000000000000000000000000000000000
0000000000000000000000000000000000000000000000000000000000000000000000000000000000000000000000000000
