11111111111111111111
10000000000000000001
10222222223333333301
10200000003300000001
10201111103301111101
10201000103301000101
10201030103301030101
10201000103301000101
10201111103301111101
10200000003300000001
10333333332222222201
10300000002200000001
10301111102201111101
10301000102201000101
10301020102201020101
10301000102201000101
10301111102201111101
10300000002200000001
10000000000000000001
11111111111111111111
