000000000000000000000000000000000000000000000000000000000000
055500000000000000000000000000000000000000000000000000000000
055000000000000000000000000000000000000000000000000000000300
055550001000000000000000000000002000000000000000000000000330
055000111100000000000000000000022022000000000000000000000330
000000011100000000000000000000002222220000000000000000303330
000000011100000000000000000000000222200000000000000000333300
000000001000000000000000000000002220000000000000110003333000
000000000000000000000000000000002200000000000001100000330000
000000000000000000000000000000000200000000011001110000000000
000000000000000000000000000000000000000000111100111000000000
000000000000000000000000000000000000000000011111110000000000
000000000000000000000000000000000000000000011111110000000000
000000000000000010000000000000000000000000111001110000000000
000000000000000011100000000000000000000000111101100000000000
000500000000000011100000000000000000000000011000000000000000
055550000000001111100000000000000001000000000000000000000000
055550000000011101000000000000000011111100000000000000000000
055550000000001100000000000000000001111000000000000000000000
005000000000000000011000000000000001000000000000000000000000
005000000000000000111110333000000200000000000002000000000000
005550000000000000011000333300002200000000000002200000000000
005055000000000000001000333300002222000000000222000000000000
000055000000003000000000033300022222200000000022220000000000
000050000000003330000000030000000222000000000022200000000000
000000000000333330300000000000000000000000000022200000000000
000000000000030330300000000000000000000030000022220000000000
000000000001000333330000000000000000003333300022200000000000
000000000011000003300000000000000000033330330002220000000000
000000000011111100300000000000000000033333333000200000000000
000000000001111110000000000000000000033330330000003000000000
000000000001100110000000000000000000000033000000033300000000
010000000000000100000000000000000000110000000000033300000000
011000000000000000000000000000000011111100000000330300000000
011000000000022222000000000000000101011100000000033300000000
010000000000002222000040000001111110011110100000033000000000
000000000000022220044044000011111000001101110000000000000000
000000000000002000444444000011100000001111111000000000000110
000000000000000000000040000000110000000000100000000000001110
000000000000000000000044400040000000000000000000000000000110
000000000000000000004440004444000000000000000000000000000000
000000000000000000000044000440400000000000000000000000000000
000000000000000000011004444444440000000000000000000000000000
000300000000000000111000404404400000000000000000000000000000
030330000000000000010000444444001000000000000000000000000000
033330000000000000000444444440011100000000000000000000000000
033030000000000000000044404440001100000000000000000000000000
033330000000000000000004444440001000110000000000000020000000
033330000000000000000000444440000000101000330000000222222000
000330000000000000000000000440000011111100333000000022022000
003330000000000000000000110400000011011003333000001002222200
000300000000000000000001110000000111100000333000011102220000
000000300300000000000011110000000011100000003300001002222000
000000330300000000000001100000000011100000100000001002000000
000000333333000000000000001000000001000000110000000000000000
000003333300000000000000011100000000000011100000022220000000
000000330300000000000000111000110000000111100000222000000000
000000000000000000000000111001111000001111100002222200000000
000000000000000000000000111000011111000111000220202000000000
000000000000000000000000000000000000000000000000000000000000
